+-+-+-+-+-+
|        g| 
+       +-+
|         | 
+ +-+-+-+ + 
|     |   | 
+     +   + 
|         | 
+-+-+     + 
|s        | 
+-+-+-+-+-+